"filename", "language", "C++", "Markdown", "comment", "blank", "total"
"d:\nycu course\2025_spring\Data Structures and Object-oriented Programming\hw1\Hw_1_to_do_list\to_do_list\README.md", "Markdown", 0, 2, 0, 1, 3
"d:\nycu course\2025_spring\Data Structures and Object-oriented Programming\hw1\Hw_1_to_do_list\to_do_list\header\Basic_task.h", "C++", 17, 0, 0, 5, 22
"d:\nycu course\2025_spring\Data Structures and Object-oriented Programming\hw1\Hw_1_to_do_list\to_do_list\header\CompareSet.h", "C++", 49, 0, 0, 9, 58
"d:\nycu course\2025_spring\Data Structures and Object-oriented Programming\hw1\Hw_1_to_do_list\to_do_list\header\calendar.h", "C++", 27, 0, 0, 9, 36
"d:\nycu course\2025_spring\Data Structures and Object-oriented Programming\hw1\Hw_1_to_do_list\to_do_list\header\check.h", "C++", 13, 0, 0, 5, 18
"d:\nycu course\2025_spring\Data Structures and Object-oriented Programming\hw1\Hw_1_to_do_list\to_do_list\header\cmd_rec.h", "C++", 19, 0, 0, 9, 28
"d:\nycu course\2025_spring\Data Structures and Object-oriented Programming\hw1\Hw_1_to_do_list\to_do_list\header\sort_cmp.h", "C++", 16, 0, 0, 8, 24
"d:\nycu course\2025_spring\Data Structures and Object-oriented Programming\hw1\Hw_1_to_do_list\to_do_list\header\task.h", "C++", 29, 0, 4, 17, 50
"d:\nycu course\2025_spring\Data Structures and Object-oriented Programming\hw1\Hw_1_to_do_list\to_do_list\header\to_do_list.h", "C++", 56, 0, 24, 33, 113
"d:\nycu course\2025_spring\Data Structures and Object-oriented Programming\hw1\Hw_1_to_do_list\to_do_list\header\user.h", "C++", 31, 0, 0, 20, 51
"d:\nycu course\2025_spring\Data Structures and Object-oriented Programming\hw1\Hw_1_to_do_list\to_do_list\src\calendar.cpp", "C++", 119, 0, 0, 12, 131
"d:\nycu course\2025_spring\Data Structures and Object-oriented Programming\hw1\Hw_1_to_do_list\to_do_list\src\check.cpp", "C++", 68, 0, 0, 8, 76
"d:\nycu course\2025_spring\Data Structures and Object-oriented Programming\hw1\Hw_1_to_do_list\to_do_list\src\main.cpp", "C++", 269, 0, 57, 47, 373
"d:\nycu course\2025_spring\Data Structures and Object-oriented Programming\hw1\Hw_1_to_do_list\to_do_list\src\sort_cmp.cpp", "C++", 32, 0, 0, 8, 40
"d:\nycu course\2025_spring\Data Structures and Object-oriented Programming\hw1\Hw_1_to_do_list\to_do_list\src\task.cpp", "C++", 59, 0, 1, 16, 76
"d:\nycu course\2025_spring\Data Structures and Object-oriented Programming\hw1\Hw_1_to_do_list\to_do_list\src\test.cpp", "C++", 9, 0, 0, 6, 15
"d:\nycu course\2025_spring\Data Structures and Object-oriented Programming\hw1\Hw_1_to_do_list\to_do_list\src\tmp.cpp", "C++", 432, 0, 58, 52, 542
"d:\nycu course\2025_spring\Data Structures and Object-oriented Programming\hw1\Hw_1_to_do_list\to_do_list\src\to_do_list.cpp", "C++", 472, 0, 18, 136, 626
"d:\nycu course\2025_spring\Data Structures and Object-oriented Programming\hw1\Hw_1_to_do_list\to_do_list\src\to_do_list_cmd.cpp", "C++", 447, 0, 3, 73, 523
"d:\nycu course\2025_spring\Data Structures and Object-oriented Programming\hw1\Hw_1_to_do_list\to_do_list\src\user.cpp", "C++", 302, 0, 2, 78, 382
"Total", "-", 2466, 2, 167, 552, 3187