"filename", "language", "C++", "Markdown", "comment", "blank", "total"
"d:\nycu course\2025_spring\Data Structures and Object-oriented Programming\hw1\Hw_1_to_do_list\to_do_list\README.md", "Markdown", 0, 2, 0, 1, 3
"d:\nycu course\2025_spring\Data Structures and Object-oriented Programming\hw1\Hw_1_to_do_list\to_do_list\header\Basic_task.h", "C++", 17, 0, 0, 5, 22
"d:\nycu course\2025_spring\Data Structures and Object-oriented Programming\hw1\Hw_1_to_do_list\to_do_list\header\CompareSet.h", "C++", 49, 0, 0, 9, 58
"d:\nycu course\2025_spring\Data Structures and Object-oriented Programming\hw1\Hw_1_to_do_list\to_do_list\header\calendar.h", "C++", 24, 0, 0, 11, 35
"d:\nycu course\2025_spring\Data Structures and Object-oriented Programming\hw1\Hw_1_to_do_list\to_do_list\header\check.h", "C++", 13, 0, 0, 5, 18
"d:\nycu course\2025_spring\Data Structures and Object-oriented Programming\hw1\Hw_1_to_do_list\to_do_list\header\handle_input.h", "C++", 15, 0, 0, 4, 19
"d:\nycu course\2025_spring\Data Structures and Object-oriented Programming\hw1\Hw_1_to_do_list\to_do_list\header\print_line.h", "C++", 17, 0, 0, 5, 22
"d:\nycu course\2025_spring\Data Structures and Object-oriented Programming\hw1\Hw_1_to_do_list\to_do_list\header\sort_cmp.h", "C++", 16, 0, 0, 8, 24
"d:\nycu course\2025_spring\Data Structures and Object-oriented Programming\hw1\Hw_1_to_do_list\to_do_list\header\task.h", "C++", 27, 0, 4, 15, 46
"d:\nycu course\2025_spring\Data Structures and Object-oriented Programming\hw1\Hw_1_to_do_list\to_do_list\header\to_do_list.h", "C++", 47, 0, 10, 28, 85
"d:\nycu course\2025_spring\Data Structures and Object-oriented Programming\hw1\Hw_1_to_do_list\to_do_list\header\user.h", "C++", 32, 0, 0, 21, 53
"d:\nycu course\2025_spring\Data Structures and Object-oriented Programming\hw1\Hw_1_to_do_list\to_do_list\src\calendar.cpp", "C++", 127, 0, 0, 28, 155
"d:\nycu course\2025_spring\Data Structures and Object-oriented Programming\hw1\Hw_1_to_do_list\to_do_list\src\check.cpp", "C++", 51, 0, 0, 10, 61
"d:\nycu course\2025_spring\Data Structures and Object-oriented Programming\hw1\Hw_1_to_do_list\to_do_list\src\handle_input.cpp", "C++", 195, 0, 0, 25, 220
"d:\nycu course\2025_spring\Data Structures and Object-oriented Programming\hw1\Hw_1_to_do_list\to_do_list\src\main.cpp", "C++", 24, 0, 52, 10, 86
"d:\nycu course\2025_spring\Data Structures and Object-oriented Programming\hw1\Hw_1_to_do_list\to_do_list\src\print_line.cpp", "C++", 71, 0, 0, 12, 83
"d:\nycu course\2025_spring\Data Structures and Object-oriented Programming\hw1\Hw_1_to_do_list\to_do_list\src\sort_cmp.cpp", "C++", 32, 0, 0, 6, 38
"d:\nycu course\2025_spring\Data Structures and Object-oriented Programming\hw1\Hw_1_to_do_list\to_do_list\src\t_do_list_man.cpp", "C++", 69, 0, 0, 9, 78
"d:\nycu course\2025_spring\Data Structures and Object-oriented Programming\hw1\Hw_1_to_do_list\to_do_list\src\task.cpp", "C++", 58, 0, 0, 14, 72
"d:\nycu course\2025_spring\Data Structures and Object-oriented Programming\hw1\Hw_1_to_do_list\to_do_list\src\to_do_list.cpp", "C++", 135, 0, 1, 29, 165
"d:\nycu course\2025_spring\Data Structures and Object-oriented Programming\hw1\Hw_1_to_do_list\to_do_list\src\to_do_list_add.cpp", "C++", 92, 0, 0, 17, 109
"d:\nycu course\2025_spring\Data Structures and Object-oriented Programming\hw1\Hw_1_to_do_list\to_do_list\src\to_do_list_calendar.cpp", "C++", 374, 0, 2, 95, 471
"d:\nycu course\2025_spring\Data Structures and Object-oriented Programming\hw1\Hw_1_to_do_list\to_do_list\src\to_do_list_cmd.cpp", "C++", 13, 0, 0, 5, 18
"d:\nycu course\2025_spring\Data Structures and Object-oriented Programming\hw1\Hw_1_to_do_list\to_do_list\src\to_do_list_del.cpp", "C++", 60, 0, 0, 14, 74
"d:\nycu course\2025_spring\Data Structures and Object-oriented Programming\hw1\Hw_1_to_do_list\to_do_list\src\to_do_list_edit.cpp", "C++", 136, 0, 0, 23, 159
"d:\nycu course\2025_spring\Data Structures and Object-oriented Programming\hw1\Hw_1_to_do_list\to_do_list\src\to_do_list_undo_redo.cpp", "C++", 79, 0, 1, 13, 93
"d:\nycu course\2025_spring\Data Structures and Object-oriented Programming\hw1\Hw_1_to_do_list\to_do_list\src\to_do_list_view.cpp", "C++", 102, 0, 1, 14, 117
"d:\nycu course\2025_spring\Data Structures and Object-oriented Programming\hw1\Hw_1_to_do_list\to_do_list\src\user.cpp", "C++", 355, 0, 1, 100, 456
"Total", "-", 2230, 2, 72, 536, 2840