"filename", "language", "Markdown", "C++", "comment", "blank", "total"
"d:\nycu course\2025_spring\Data Structures and Object-oriented Programming\hw1\Hw_1_to_do_list\to_do_list\README.md", "Markdown", 2, 0, 0, 1, 3
"d:\nycu course\2025_spring\Data Structures and Object-oriented Programming\hw1\Hw_1_to_do_list\to_do_list\header\Basic_task.h", "C++", 0, 17, 0, 5, 22
"d:\nycu course\2025_spring\Data Structures and Object-oriented Programming\hw1\Hw_1_to_do_list\to_do_list\header\CompareSet.h", "C++", 0, 49, 0, 9, 58
"d:\nycu course\2025_spring\Data Structures and Object-oriented Programming\hw1\Hw_1_to_do_list\to_do_list\header\calendar.h", "C++", 0, 24, 0, 11, 35
"d:\nycu course\2025_spring\Data Structures and Object-oriented Programming\hw1\Hw_1_to_do_list\to_do_list\header\check.h", "C++", 0, 13, 0, 5, 18
"d:\nycu course\2025_spring\Data Structures and Object-oriented Programming\hw1\Hw_1_to_do_list\to_do_list\header\handle_input.h", "C++", 0, 15, 0, 4, 19
"d:\nycu course\2025_spring\Data Structures and Object-oriented Programming\hw1\Hw_1_to_do_list\to_do_list\header\print_line.h", "C++", 0, 17, 0, 5, 22
"d:\nycu course\2025_spring\Data Structures and Object-oriented Programming\hw1\Hw_1_to_do_list\to_do_list\header\sort_cmp.h", "C++", 0, 16, 0, 8, 24
"d:\nycu course\2025_spring\Data Structures and Object-oriented Programming\hw1\Hw_1_to_do_list\to_do_list\header\task.h", "C++", 0, 27, 4, 15, 46
"d:\nycu course\2025_spring\Data Structures and Object-oriented Programming\hw1\Hw_1_to_do_list\to_do_list\header\to_do_list.h", "C++", 0, 47, 10, 28, 85
"d:\nycu course\2025_spring\Data Structures and Object-oriented Programming\hw1\Hw_1_to_do_list\to_do_list\header\user.h", "C++", 0, 32, 0, 21, 53
"d:\nycu course\2025_spring\Data Structures and Object-oriented Programming\hw1\Hw_1_to_do_list\to_do_list\src\calendar.cpp", "C++", 0, 127, 0, 28, 155
"d:\nycu course\2025_spring\Data Structures and Object-oriented Programming\hw1\Hw_1_to_do_list\to_do_list\src\check.cpp", "C++", 0, 51, 0, 10, 61
"d:\nycu course\2025_spring\Data Structures and Object-oriented Programming\hw1\Hw_1_to_do_list\to_do_list\src\handle_input.cpp", "C++", 0, 195, 0, 25, 220
"d:\nycu course\2025_spring\Data Structures and Object-oriented Programming\hw1\Hw_1_to_do_list\to_do_list\src\main.cpp", "C++", 0, 24, 52, 10, 86
"d:\nycu course\2025_spring\Data Structures and Object-oriented Programming\hw1\Hw_1_to_do_list\to_do_list\src\print_line.cpp", "C++", 0, 71, 0, 12, 83
"d:\nycu course\2025_spring\Data Structures and Object-oriented Programming\hw1\Hw_1_to_do_list\to_do_list\src\sort_cmp.cpp", "C++", 0, 32, 0, 6, 38
"d:\nycu course\2025_spring\Data Structures and Object-oriented Programming\hw1\Hw_1_to_do_list\to_do_list\src\task.cpp", "C++", 0, 58, 0, 14, 72
"d:\nycu course\2025_spring\Data Structures and Object-oriented Programming\hw1\Hw_1_to_do_list\to_do_list\src\to_do_list.cpp", "C++", 0, 418, 3, 119, 540
"d:\nycu course\2025_spring\Data Structures and Object-oriented Programming\hw1\Hw_1_to_do_list\to_do_list\src\to_do_list_cmd.cpp", "C++", 0, 491, 1, 76, 568
"d:\nycu course\2025_spring\Data Structures and Object-oriented Programming\hw1\Hw_1_to_do_list\to_do_list\src\user.cpp", "C++", 0, 355, 1, 100, 456
"Total", "-", 2, 2079, 71, 512, 2664