"filename", "language", "C++", "comment", "blank", "total"
"d:\nycu course\2025_spring\Data Structures and Object-oriented Programming\hw1\Hw_1_to_do_list\to_do_list\header\Basic_task.h", "C++", 6, 0, 0, 6
"d:\nycu course\2025_spring\Data Structures and Object-oriented Programming\hw1\Hw_1_to_do_list\to_do_list\header\CompareSet.h", "C++", -49, 0, -9, -58
"d:\nycu course\2025_spring\Data Structures and Object-oriented Programming\hw1\Hw_1_to_do_list\to_do_list\header\calendar.h", "C++", 1, 0, 1, 2
"d:\nycu course\2025_spring\Data Structures and Object-oriented Programming\hw1\Hw_1_to_do_list\to_do_list\header\handle_input.h", "C++", -9, 0, 0, -9
"d:\nycu course\2025_spring\Data Structures and Object-oriented Programming\hw1\Hw_1_to_do_list\to_do_list\header\print_line.h", "C++", -1, 0, 0, -1
"d:\nycu course\2025_spring\Data Structures and Object-oriented Programming\hw1\Hw_1_to_do_list\to_do_list\header\sort_cmp.h", "C++", -7, 0, 0, -7
"d:\nycu course\2025_spring\Data Structures and Object-oriented Programming\hw1\Hw_1_to_do_list\to_do_list\header\task.h", "C++", -7, 0, 0, -7
"d:\nycu course\2025_spring\Data Structures and Object-oriented Programming\hw1\Hw_1_to_do_list\to_do_list\header\to_do_list.h", "C++", -1, 0, 0, -1
"d:\nycu course\2025_spring\Data Structures and Object-oriented Programming\hw1\Hw_1_to_do_list\to_do_list\header\user.h", "C++", -7, 0, -1, -8
"d:\nycu course\2025_spring\Data Structures and Object-oriented Programming\hw1\Hw_1_to_do_list\to_do_list\src\calendar.cpp", "C++", 6, 0, 1, 7
"d:\nycu course\2025_spring\Data Structures and Object-oriented Programming\hw1\Hw_1_to_do_list\to_do_list\src\handle_input.cpp", "C++", 1, 0, 2, 3
"d:\nycu course\2025_spring\Data Structures and Object-oriented Programming\hw1\Hw_1_to_do_list\to_do_list\src\main.cpp", "C++", -6, 0, 2, -4
"d:\nycu course\2025_spring\Data Structures and Object-oriented Programming\hw1\Hw_1_to_do_list\to_do_list\src\print_line.cpp", "C++", 4, 0, 0, 4
"d:\nycu course\2025_spring\Data Structures and Object-oriented Programming\hw1\Hw_1_to_do_list\to_do_list\src\t_do_list_man.cpp", "C++", -69, 0, -9, -78
"d:\nycu course\2025_spring\Data Structures and Object-oriented Programming\hw1\Hw_1_to_do_list\to_do_list\src\to_do_list.cpp", "C++", -135, -1, -29, -165
"d:\nycu course\2025_spring\Data Structures and Object-oriented Programming\hw1\Hw_1_to_do_list\to_do_list\src\to_do_list_add.cpp", "C++", -92, 0, -17, -109
"d:\nycu course\2025_spring\Data Structures and Object-oriented Programming\hw1\Hw_1_to_do_list\to_do_list\src\to_do_list_calendar.cpp", "C++", -374, -2, -95, -471
"d:\nycu course\2025_spring\Data Structures and Object-oriented Programming\hw1\Hw_1_to_do_list\to_do_list\src\to_do_list_class\to_do_list.cpp", "C++", 78, 0, 19, 97
"d:\nycu course\2025_spring\Data Structures and Object-oriented Programming\hw1\Hw_1_to_do_list\to_do_list\src\to_do_list_class\to_do_list_add.cpp", "C++", 80, 0, 17, 97
"d:\nycu course\2025_spring\Data Structures and Object-oriented Programming\hw1\Hw_1_to_do_list\to_do_list\src\to_do_list_class\to_do_list_calendar.cpp", "C++", 348, 2, 96, 446
"d:\nycu course\2025_spring\Data Structures and Object-oriented Programming\hw1\Hw_1_to_do_list\to_do_list\src\to_do_list_class\to_do_list_del.cpp", "C++", 47, 0, 14, 61
"d:\nycu course\2025_spring\Data Structures and Object-oriented Programming\hw1\Hw_1_to_do_list\to_do_list\src\to_do_list_class\to_do_list_edit.cpp", "C++", 123, 0, 24, 147
"d:\nycu course\2025_spring\Data Structures and Object-oriented Programming\hw1\Hw_1_to_do_list\to_do_list\src\to_do_list_class\to_do_list_man.cpp", "C++", 56, 0, 9, 65
"d:\nycu course\2025_spring\Data Structures and Object-oriented Programming\hw1\Hw_1_to_do_list\to_do_list\src\to_do_list_class\to_do_list_undo_redo.cpp", "C++", 66, 1, 13, 80
"d:\nycu course\2025_spring\Data Structures and Object-oriented Programming\hw1\Hw_1_to_do_list\to_do_list\src\to_do_list_class\to_do_list_view.cpp", "C++", 90, 1, 13, 104
"d:\nycu course\2025_spring\Data Structures and Object-oriented Programming\hw1\Hw_1_to_do_list\to_do_list\src\to_do_list_cmd.cpp", "C++", -13, 0, -5, -18
"d:\nycu course\2025_spring\Data Structures and Object-oriented Programming\hw1\Hw_1_to_do_list\to_do_list\src\to_do_list_del.cpp", "C++", -60, 0, -14, -74
"d:\nycu course\2025_spring\Data Structures and Object-oriented Programming\hw1\Hw_1_to_do_list\to_do_list\src\to_do_list_edit.cpp", "C++", -136, 0, -23, -159
"d:\nycu course\2025_spring\Data Structures and Object-oriented Programming\hw1\Hw_1_to_do_list\to_do_list\src\to_do_list_undo_redo.cpp", "C++", -79, -1, -13, -93
"d:\nycu course\2025_spring\Data Structures and Object-oriented Programming\hw1\Hw_1_to_do_list\to_do_list\src\to_do_list_view.cpp", "C++", -102, -1, -14, -117
"d:\nycu course\2025_spring\Data Structures and Object-oriented Programming\hw1\Hw_1_to_do_list\to_do_list\src\user.cpp", "C++", -11, 0, -4, -15
"Total", "-", -252, -1, -22, -275